12 12
|----------|
|.G..|.....|
|....|.....|
|....|--...|
|..........|
|..........|
|....G.....|
|......----|
|..........|
|---....P..|
|..........|
|----------|