12 14
|------------|
|G..........G|
|.|--|.|---|.|
|.|--|.|---|.|
|............|
|.|-----.---.|
|.|....G.....|
|.|.|---.-.--|
|...|........|
|.|-|.|----|.|
|P....|.....G|
|------------|